{
    "name": "ermmm 2",
    "player_pos": [ 2, 2 ],
    
    "win_amount": 2,

    "crate_count": 2,
    "crates": [[ 6, 7 ], [ 3, 4 ]],

    "map": [ 
        [ 2, 2, 2, 2, 2, 2, 2, 2, 2 ],
        [ 2, 1, 1, 1, 1, 1, 1, 1, 2 ],
        [ 2, 1, 1, 1, 1, 1, 1, 1, 2 ],
        [ 2, 1, 1, 1, 1, 1, 1, 1, 2 ],
        [ 2, 1, 1, 1, 1, 1, 1, 1, 2 ],
        [ 2, 1, 1, 1, 2, 2, 2, 2, 2 ],
        [ 2, 1, 1, 1, 1, 1, 1, 3, 2 ],
        [ 2, 1, 1, 1, 1, 1, 3, 1, 2 ],
        [ 2, 2, 2, 2, 2, 2, 2, 2, 2 ]
    ]
}
