{
    "name": "ermmm 1",
    "player_pos": [ 5, 5 ],
    
    "win_amount": 2,

    "crate_count": 2,
    "crates": [[ 3, 3 ], [ 4, 4 ]],

    "map": [ 
        [ 2, 2, 2, 2, 2, 2, 2, 2, 2 ],
        [ 2, 1, 1, 1, 1, 1, 1, 1, 2 ],
        [ 2, 1, 1, 1, 1, 1, 1, 1, 2 ],
        [ 2, 1, 1, 1, 1, 1, 1, 1, 2 ],
        [ 2, 1, 1, 1, 1, 1, 1, 1, 2 ],
        [ 2, 1, 3, 1, 1, 1, 1, 1, 2 ],
        [ 2, 1, 2, 2, 1, 1, 1, 1, 2 ],
        [ 2, 1, 1, 3, 1, 1, 1, 1, 2 ],
        [ 2, 2, 2, 2, 2, 2, 2, 2, 2 ]
    ]
}
